############+############
#.......................#
#...^...............^...#
#.......................#
#.......................#
#.......................#
#.......................#
+.......................+
#.......................#
#.......................#
#.......................#
#.......................#
#...^...............^...#
#.......................#
#########################
