############+############
#.......................#
#...^...............^...#
#....e.............e....#
#.......................#
#.......................#
#.......................#
+.......................+
#.......................#
#.......................#
#.......................#
#....e.............e....#
#...^...............^...#
#.......................#
############+############
