############+############
#.......................#
#..........#............#
#.......................#
#.......................#
#.......................#
#.......................#
+.......................+
#.......................#
#.......................#
#.......................#
#.......................#
#.......................#
#.......................#
############+############
