#########################
#..###..###..###..###..##
##..####..####..####..###
#..###..###..###..###..##
##..####..####..####..###
#..###..###..###..###..##
##..####..####..####..###
#..###..###..###..###..##
##..####..####..####..###
#..###..###..###..###..##
##..####..####..####..###
#..###..###..###..###..##
##..####..####..####..###
#..###..###..###..###..##
#########################
