############+############
#......................##
##..####..####..####..###
#..###..###..###..###..##
##..####..####..####..###
#..###..###..###..###..##
##..####..####..####..###
+.............^^........+
##..####..####..####..###
#..###..###..###..###..##
##..####..####..####..###
#..###..###..###..###..##
##..####..####..####..###
#......................##
############+############
