############+############
#......................##
##..####..####..####..###
#..###..###..###..###..##
##..####..####..####..###
#..###..###..###..###..##
##..####..####..####..###
+.......................+
##..####..####..####..###
#..###..###..###..###..##
##..####..####..####..###
#..###..###..###..###..##
##..####..####..####..###
#......................##
############+############
