#########################
#.......................#
#.......................#
#.......................#
#.......................#
#.......................#
#.......................#
+..........E............+
#.......................#
#.......................#
#.......................#
#.......................#
#.......................#
##....................+##
#########################
