#########################
#.......................#
#.......................#
#.......................#
#.......................#
#.......................#
#.......................#
+.......................+
#.......................#
#.......................#
#.......................#
#.......................#
#.......................#
##....................+##
#########################
