############+############
##.........#.#.........##
#.......................#
#.......................#
#.......................#
#.......................#
##.........#.#.........##
+.......................+
##.........#.#.........##
#.......................#
#.......................#
#.......................#
#.......................#
##.........#.#.........##
############+############
