############+############
############.############
##.........^.^.........##
##.....................##
##.....................##
##.....................##
##^...................^##
+.......................+
##^...................^##
##.....................##
##.....................##
##.....................##
##.........^.^.........##
############.############
############+############
