############+############
##......................#
#.#.....................#
#..#..........^.........#
#...#......^............#
#....#..................#
#.....#............^....#
+...^..###########......+
#.................#.....#
#..................#....#
#........^..........#.^.#
#................^...#..#
#......^..............#.#
#......................##
############+############
