############+############
##......................#
#.#.....................#
#..#..........^.........#
#...#......^............#
#....#..................#
#.....###########..^....#
+...^............#......+
#.................#.....#
#..................#....#
#........^..........#.^.#
#................^...#..#
#......^..............#.#
#......................##
############+############
